casual	casual
checked	a cuadrados
cotton	de algod칩n
fancy	elegante
floral	floral
formal	formal
heavy	pesado/pesada
high	alto/alta
large	grande
leather	de cuero
light	ligero/ligera
linen	de lino
long	largo/larga
loose	suelto/suelta
low	bajo/baja
medium	mediano/mediana
narrow	estrecho/estrecha
new	nuevo/nueva
nylon	de nylon
old	viejo/vieja
plaid	tart치n
plain	simple
short	corto/corta
silk	de seda
small	peque침o/peque침a
striped	a rayas
tight	apretado/apretada
turtleneck	de cuello de tortuga
wide	ancho/ancha
wool	de lana
striped	a rayas
tight	apretado/apretada
turtleneck	de cuello de tortuga
wide	ancho/ancha
wool	de lana